f f f f f f f f f f f f f f f f f f f f f f f f f f f f f f f f f f f f f f f f f f f f f f f f f f f f f f f
f # # # # # # # # # # # # # # # # # # # # # # # # # # # # # # # # # # # # # # # # # # # # # # # # # # # # # f
f # # f f # f f # # # # # # # # # # # # # # # # # # # # # # # # # # # # # # # # # # # # # # # # # # # # # # f
f # # # # # # # # # # # # # # # # # # # # # # # # # # # # # # # # # # # # # # # # # # # # # # # # # # # # # f
f # # # # # # # # # # # # # # # # # # # # # # # # # # # # # # # # # # # # # # # # # # # # # # # # # # # # # f
f # # # # # # # # # # # # # # # # # # # # # # # # # # # # # # # # # # # # # # # # # # # # # # # # # # # # # f
f # # # # # # # # # # # # # # # # # # # # # # # # # # # # # # # # # # # # # # # # # # # # # # # # # # # # # f
f # # # # # # # # # # # # # # # # # # # # # # # # # # # # # # # # # # # # # # # # # # # # # # # # # # # # # f
f # # # # # # # # # # # # # # # # # # # # # # # # # # # # # # # # # # # # # # # # # # # # # # # # # # # # # f
f # # f f f f f # # # # # # # # # # # # # # # # # # # # # # # # # # # # # # # # # # # # # # # # # # # # # # f
f # # # # # # # # # # # # # # # # # # # # # # # # # # # # # # # # # # # # # # # # # # # # # # # # # # # # # f
f # # # # # # # # # # # # # # # # # # # # # # # # # # # # # # # # # # # # # # # # # # # # # # # # # # # # # f
f # # # # # # # # # # # # # # # # # # # # # # # # # # # # # # # # # # # # # # # # # # # # # # # # # # # # # f
f # # # c # # # # # # # # # # # # # # # # # # # # # # # # # # # # # # # # # # # # # # # # # # # # # # # # # f
f # # # # # # # # # # # # # # # # # # # # # # # # # # # # # # # # # # # # # # # # # # # # # # # # # # # # # f
f # # # # # c # # # # p p p p # # # # # # # # # # # # # # # # # # # # # # # # # # # # # # # # # # # # # # # f
f # # # # # # # # # # # # # # # # # # # # # # # # # # # # # # # # # # # # # # # # # # # # # # # # # # # # # f
f # f p p p # # # # # # # # # # # # # # # # # # # # # # # # # # # # # # # # # # # # # # # # # # # # # # # # f
f # f # # # # # # # # # # # # # # # # # # # # # # # # # # # # # # # # # # # # # # # # # # # # # # # # # # # f
f # # # # # # # # # # # # # # # # # # # # # # # # # # # # # # # # # # # # # # # # # # # # # # # # # # # # # f
f # # # # # b # # f p # # # # # # # # # # # # # # # # # # # # # # # # # # # # # # # # # # # # # # # # # # # f
f f f f f f f f f f # # # # # # # # # # # # # # # # # # # # # # # # # # # # # # # # # # # # # # # # # # # # f
f # # # # f # # # # # # # # # # # # # # # # # # # # # # # # # # # # # # # # # # # # # # # # # # # # # # # # f
f # # # # f # # # # # # # # # # # # # # # # # # # # # # # # # # # # # # # # # # # # # # # # # # # # # # # # f
f # # # # f # s # # # # # # # # # # # # # # # # # # # # # # # # # # # # # # # # # # # # # # # # # # # # # # f
f # # # # f p p p # # # # # # # # # c # # # # # # # # # # # # # # # # # # # # # # # # # # # # # # # # # # # f
f # # # # f # # # # # # # # # # # # # # # # # # # # # # # # # # # # # # # # # # # # # # # # # # # # # # # # f
f # # # # # # # # # # m # # # # # # # # # # # # # # # # # # # # # # # # # # # # # # # # # # # # # # # # # # f
f f f f f f f f f f f f # # # # # # # # # # # # # f f f f f f f f f f f f f f f f f f f f f f f f f f f f f f
f f f f f f f f f f f f # # # # # # # # # # # # # f f f f f f f f f f f f f f f f f f f f f f f f f f f f f f 